.....X....
R....X....
..........
.....X....
.....X....